...P.......D.......
...P........P......
...P........P......
...P........P......
...W........P......
...W........P....2.
.G.W........P......
PPPPPPPPQQQPPPPPPPP
...................
.................1.
...................