....................
............X.......
............X.......
............X.......
............X.......
....................
....................
....................
XXXXXXXX....XXXXXXXX
....................
....................
....................