...P..D..D.........
...P...............
...P...............
...P...........2...
...W....0..........
...W...........0...
.G.W...............
PPPPPPPPQQQPPPPPPPP
....D.........D....
..........0......1.
...................