...................
............P......
............P......
............P......
............W......
............W....2.
............W......
PPPPPPPPQQQPPPPPPPP
...................
.................1.
...................