.................D.
.G.................
PPPPPPPPPPPPPPPP...
.D.................
.....1...........0.
...PPPPPQQQPPPPPPPP
.................D.
...................
PPP.PPPPPPPPPPPP...
...................
.......0..0..0.....