PPPPPPPPPPPPPPPPPPP
PPPPPPPPPPPPPPPPPPP
PPPPPPPPPPPPPPPPPPP
PPPPPPPPPPPPPPPPPPP
PPPPPPPPPPPPPPPPPPP
PPPPPPPPPPPPPPPPPPP
PPPPPPPPPPPPPPPPPPP
PPPPPPPPPPPPPPPPPPP
...D..D..D..D.Q....
......1.......Q....
..............Q..G.