....W............D.
.G..W..............
PPPPPPPPPPPPPPPP...
..D................
.....1...........0.
2..PPPPPQQQPPPPPPPP
.................D.
...................
PPP.PPPPPPPPPPPP...
...................
.......0..0..0.....