....W............D.
.G..W..............
PPPPPPPPPPPPPPPP...
..D................
.........0.........
1..PPPPPQQQPPPPPPPP
.................D.
...................
PPP.PPPPPPPPPPPP..2
...................
.......0..0..0.....