...P...............
...P........P......
...P........P......
...P........P..2...
...W........P......
...W........P......
.G.W..0.....P......
PPPPPPPPPQQPPPPPPPP
..............D....
.................1.
...................