PPPPPPPPPPPPPPPPPPP
PPPPPPPPPPPPPPPPPPP
PPP.............PPP
PPP.............PPP
PPP.............PPP
PPP.............PPP
PPPPPPPPPPPPPPPPPPP
PPPPPPPPPPPPPPPPPPP
........D..........
...................
.................G.