...P...............
...P........P......
...P........P......
...P........P......
...W........P......
.G.W........P....2.
.G.W........P......
PPPPPPPPQQQPPPPPPPP
...................
.................1.
...................