...D.Q.......Q.D...
.....Q...0...Q.....
.....PP.PPP.PP.....
1.....P.....P......
......PPPWPPP......
PP....PPPWPPP....PP
......P.....P......
......P..G..P......
.....PPPPPPPPP...2.
.....PPPPPPPPP.....
.....PPPPPPPPP.....